11111111111
00000010001
10111110101
10000010101
10111010101
10101000101
10101111101
10100010101
10101010101
10001010002
11111111111